. # # # .
. . # . .
. # . . #
. . . # #
# . . . .